[    [1,1,1,1,1,1,1,1,1,1,1], 
     [1,2,2,2,2,2,2,2,2,2,1], 
     [1,2,5,2,5,2,5,5,5,2,1],
     [1,2,5,2,5,2,2,2,5,2,1],
     [1,2,5,2,5,2,2,2,5,2,1],
     [1,2,5,5,5,2,5,5,5,2,1],
     [1,2,2,2,5,2,5,2,2,2,1],
     [1,2,2,2,5,2,4,3,2,2,1],
     [1,2,2,2,5,2,5,5,5,2,1],
     [1,6,2,2,2,2,2,2,2,2,1],
     [1,1,1,1,1,1,1,1,1,1,1]       ]